#########,#####
###       #####
### ###########
### #####   ###
###     ### ###
####### ### ###
#   ### ### ###
# ##### ### ###
#           ###
#######.#######